[25 10]
4
XXXXXXXXXXXXXXXXXXXXXXXXX
X H ....................X
XXXXXXXXXX..............X
X.......................X
X..............RRRR.....X
X..............DDDD.....X
X.............D....D....O
X..A..........D    D....X
X..A.L..y.....D   MD....X
XXXXXXXXXXXXXXXXXXXXXXXXX

